2
6 6 6 6 6 6 1 1 6 6 6 6 6 6 1 1 6 6 6 6 6 6 6 6 6 6 
6 6 6 6 6 6 1 1 6 6 6 6 6 6 1 1 6 6 6 6 6 6 6 6 6 6 
6 6 0 0 6 6 1 1 6 6 6 6 6 6 0 0 6 6 0 0 6 6 0 0 6 6 
6 6 0 0 6 6 1 1 6 6 6 6 6 6 0 0 6 6 0 0 6 6 0 0 6 6 
6 6 0 0 6 6 6 6 6 6 6 6 0 0 0 0 6 6 0 0 1 1 0 0 6 6 
6 6 0 0 6 6 6 6 6 6 6 6 0 0 0 0 6 6 0 0 1 1 0 0 6 6 
6 6 6 6 6 6 0 0 6 6 6 6 6 6 6 6 6 6 1 1 6 6 6 6 6 6 
6 6 6 6 6 6 0 0 6 6 6 6 6 6 6 6 6 6 1 1 6 6 6 6 6 6 
7 7 6 6 6 6 0 0 6 6 6 6 1 1 6 6 6 6 0 0 7 7 0 0 1 1 
7 7 6 6 6 6 0 0 6 6 6 6 1 1 6 6 6 6 0 0 7 7 0 0 1 1 
7 7 7 7 6 6 6 6 6 6 0 0 6 6 6 6 1 1 6 6 7 7 6 6 6 6 
7 7 7 7 6 6 6 6 6 6 0 0 6 6 6 6 1 1 6 6 7 7 6 6 6 6 
6 6 0 0 0 0 0 0 7 7 7 7 7 7 1 1 6 6 6 6 7 7 0 0 6 6 
6 6 0 0 0 0 0 0 7 7 7 7 7 7 1 1 6 6 6 6 7 7 0 0 6 6 
6 6 6 6 6 6 1 1 7 7 0 0 6 6 0 0 6 6 0 0 6 6 0 0 6 6 
6 6 6 6 6 6 1 1 7 7 0 0 6 6 0 0 6 6 0 0 6 6 0 0 6 6 
1 1 0 0 6 6 1 1 6 6 0 0 6 6 0 0 6 6 6 6 6 6 0 0 6 6 
1 1 0 0 6 6 1 1 6 6 0 0 6 6 0 0 6 6 6 6 6 6 0 0 6 6 
6 6 0 0 6 6 0 0 6 6 0 0 0 0 0 0 6 6 0 0 1 1 0 0 6 6 
6 6 0 0 6 6 0 0 6 6 0 0 0 0 0 0 6 6 0 0 1 1 0 0 6 6 
6 6 0 0 6 6 0 0 6 6 0 0 0 0 0 0 6 6 6 6 6 6 6 6 6 6 
6 6 0 0 6 6 0 0 6 6 0 0 0 0 0 0 6 6 6 6 6 6 6 6 6 6 
6 6 0 0 6 6 6 6 6 6 6 6 6 6 6 6 6 6 0 0 6 6 0 0 6 6 
6 6 0 0 6 6 6 6 6 6 6 0 0 0 0 6 6 6 0 0 6 6 0 0 6 6 
6 6 0 0 6 6 0 0 6 6 6 0 12 13 0 6 6 6 0 0 0 0 0 0 6 6 
6 6 0 0 6 6 0 0 6 6 6 0 14 15 0 6 6 6 0 0 0 0 0 0 6 6 
