2
6 6 6 6 6 6 6 6 6 6 6 6 6 6 6 6 6 6 6 6 6 6 6 6 6 6 
6 6 6 6 6 6 6 6 6 6 6 6 6 6 6 6 6 6 6 6 6 6 6 6 6 6 
6 0 6 6 6 6 6 6 6 6 6 6 6 6 6 6 6 6 6 6 6 6 6 6 6 6 
6 0 6 6 6 6 6 6 6 6 6 6 6 6 0 0 0 0 0 0 6 6 6 6 6 6 
6 0 6 6 6 6 6 6 6 6 6 6 6 0 6 6 6 6 6 6 0 6 6 6 6 6 
6 0 6 6 6 6 6 6 6 6 6 6 6 0 6 6 6 6 6 6 0 6 6 6 6 6 
6 0 6 6 6 6 6 6 6 6 6 6 6 0 6 6 6 6 6 6 0 6 6 6 6 6 
6 0 6 6 6 6 6 6 6 6 6 6 6 0 6 6 6 6 6 6 0 6 6 6 6 6 
6 0 6 6 6 6 6 6 6 6 6 6 6 0 6 6 6 6 6 6 0 6 6 6 6 6 
6 0 6 6 6 6 6 6 6 6 6 6 6 0 6 6 6 6 6 6 0 6 6 6 6 6 
6 0 6 6 6 6 6 6 6 6 6 6 6 0 6 6 6 6 6 6 0 6 6 6 6 6 
6 0 6 6 6 6 6 6 6 6 6 6 6 0 6 6 6 6 6 6 0 6 6 6 6 6 
6 0 6 6 6 6 6 6 6 6 6 6 6 0 6 6 6 6 6 6 0 6 6 6 6 6 
6 0 6 6 6 6 6 6 6 6 6 6 6 0 6 6 6 6 6 6 0 6 6 6 6 6 
6 0 6 6 6 6 6 6 6 6 6 6 6 0 6 6 6 6 6 6 0 6 6 6 6 6 
6 0 6 6 6 6 6 6 6 6 6 6 6 0 6 6 6 6 6 6 0 6 6 6 6 6 
6 0 6 6 6 6 6 6 6 6 6 6 6 0 6 6 6 6 6 6 0 6 6 6 6 6 
6 0 6 6 6 6 6 6 6 6 6 6 6 0 6 6 6 6 6 6 0 6 6 6 6 6 
6 0 6 6 6 6 6 6 6 6 6 6 6 6 0 0 0 0 0 0 6 6 6 6 6 6 
6 0 6 6 6 6 6 6 6 6 6 6 6 6 6 6 6 6 6 6 6 6 6 6 6 6 
6 6 6 6 6 6 6 6 6 6 6 6 6 6 6 6 6 6 6 6 6 6 6 6 6 6 
6 6 6 6 6 6 6 6 6 6 6 6 6 6 6 6 6 6 6 6 6 6 6 6 6 6 
6 6 6 6 6 6 6 6 6 6 6 6 6 6 6 6 6 6 6 6 6 6 6 6 6 6 
6 6 6 6 6 6 6 6 6 6 6 0 0 0 0 6 6 6 6 6 6 6 6 6 6 6 
6 6 6 6 6 6 6 6 6 6 6 0 12 13 0 6 6 6 6 6 6 6 6 6 6 6 
6 6 6 6 6 6 6 6 6 6 6 0 14 15 0 6 6 6 6 6 6 6 6 6 6 6 
