3
6 6 6 6 6 6 6 6 6 6 6 6 6 6 6 6 6 6 6 6 6 6 6 6 6 6 
6 6 6 6 6 6 6 6 6 6 6 6 6 6 6 6 6 6 6 6 6 6 6 6 6 6 
6 6 6 6 6 6 2 3 6 6 2 3 2 3 2 3 2 3 2 3 6 6 6 6 6 6 
6 6 6 6 6 6 4 5 6 6 4 5 4 5 4 5 4 5 4 5 6 6 6 6 6 6 
6 6 6 6 6 6 2 3 6 6 8 9 6 6 6 6 6 6 2 3 6 6 6 6 6 6 
6 6 6 6 6 6 4 5 6 6 10 11 6 6 6 6 6 6 4 5 6 6 6 6 6 6 
6 6 6 6 6 6 2 3 6 6 8 9 6 6 6 6 6 6 2 3 6 6 6 6 6 6 
6 6 6 6 6 6 4 5 6 6 10 11 6 6 6 6 6 6 4 5 6 6 6 6 6 6 
6 6 6 6 6 6 2 3 6 6 8 9 6 6 6 6 6 6 2 3 6 6 6 6 6 6 
6 6 6 6 6 6 4 5 6 6 10 11 6 6 6 6 6 6 4 5 6 6 6 6 6 6 
6 6 6 6 6 6 2 3 6 6 8 9 8 9 8 9 8 9 2 3 6 6 6 6 6 6 
6 6 6 6 6 6 4 5 6 6 10 11 10 11 10 11 10 11 4 5 6 6 6 6 6 6 
6 6 6 6 6 6 2 3 6 6 8 9 6 6 6 6 6 6 2 3 6 6 6 6 6 6 
6 6 6 6 6 6 4 5 6 6 10 11 6 6 6 6 6 6 4 5 6 6 6 6 6 6 
6 6 6 6 6 6 2 3 6 6 8 9 6 6 6 6 6 6 2 3 6 6 6 6 6 6 
6 6 6 6 6 6 4 5 6 6 10 11 6 6 6 6 6 6 4 5 6 6 6 6 6 6 
6 6 6 6 6 6 2 3 6 6 8 9 8 9 8 9 8 9 2 3 6 6 6 6 6 6 
6 6 6 6 6 6 4 5 6 6 10 11 10 11 10 11 10 11 4 5 6 6 6 6 6 6 
6 6 6 6 6 6 6 6 6 6 6 6 6 6 6 6 6 6 6 6 6 6 6 6 6 6 
6 6 6 6 6 6 6 6 6 6 6 6 6 6 6 6 6 6 6 6 6 6 6 6 6 6 
6 6 6 6 6 6 6 6 6 6 6 6 6 6 6 6 6 6 6 6 6 6 6 6 6 6 
6 6 6 6 6 6 6 6 6 6 6 6 6 6 6 6 6 6 6 6 6 6 6 6 6 6 
6 6 6 6 6 6 6 6 6 6 6 6 6 6 6 6 6 6 6 6 6 6 6 6 6 6 
6 6 6 6 6 6 6 6 6 6 6 0 0 0 0 6 6 6 6 6 6 6 6 6 6 6 
6 6 6 6 6 6 6 6 6 6 6 0 12 13 0 6 6 6 6 6 6 6 6 6 6 6 
6 6 6 6 6 6 6 6 6 6 6 0 14 15 0 6 6 6 6 6 6 6 6 6 6 6 
