1
6 6 6 6 6 6 6 6 6 6 6 6 6 6 6 6 6 6 6 6 6 6 6 6 6 6 
6 6 6 6 6 6 6 6 6 6 6 6 6 6 6 6 6 6 6 6 6 6 6 6 6 6 
6 0 6 6 6 6 6 6 2 3 2 3 2 3 2 3 2 3 2 3 6 6 6 6 0 6 
6 0 6 6 6 6 6 6 4 5 4 5 4 5 4 5 4 5 4 5 6 6 6 6 0 6 
6 0 6 6 6 6 6 6 2 3 0 0 0 0 0 0 0 0 2 3 6 6 6 6 0 6 
6 0 6 6 6 6 6 6 4 5 0 0 0 0 0 0 0 0 4 5 6 6 6 6 0 6 
6 0 6 6 6 6 6 6 2 3 0 0 0 0 0 0 0 0 2 3 6 6 6 6 0 6 
6 0 6 6 6 6 6 6 4 5 0 0 0 0 0 0 0 0 4 5 6 6 6 6 0 6 
6 0 6 6 6 6 6 6 2 3 0 0 0 0 0 0 0 0 2 3 6 6 6 6 0 6 
6 0 6 6 6 6 6 6 4 5 0 0 0 0 0 0 0 0 4 5 6 6 6 6 0 6 
6 0 6 6 6 6 6 6 2 3 2 3 2 3 2 3 2 3 2 3 6 6 6 6 0 6 
6 0 6 6 6 6 6 6 4 5 4 5 4 5 4 5 4 5 4 5 6 6 6 6 0 6 
6 0 6 6 6 6 6 6 0 0 0 0 0 0 0 0 0 0 2 3 6 6 6 6 0 6 
6 0 6 6 6 6 6 6 0 0 0 0 0 0 0 0 0 0 4 5 6 6 6 6 0 6 
6 0 6 6 6 6 6 6 0 0 0 0 0 0 0 0 0 0 2 3 6 6 6 6 0 6 
6 0 6 6 6 6 6 6 0 0 0 0 0 0 0 0 0 0 4 5 6 6 6 6 0 6 
6 0 6 6 6 6 6 6 0 0 0 0 0 0 0 0 0 0 2 3 6 6 6 6 0 6 
6 0 6 6 6 6 6 6 0 0 0 0 0 0 0 0 0 0 4 5 6 6 6 6 0 6 
6 0 6 6 6 6 6 6 2 3 2 3 2 3 2 3 2 3 2 3 6 6 6 6 0 6 
6 0 6 6 6 6 6 6 4 5 4 5 4 5 4 5 4 5 4 5 6 6 6 6 0 6 
6 6 6 6 6 6 6 6 6 6 6 6 6 6 6 6 6 6 6 6 6 6 6 6 6 6 
6 6 6 6 6 6 6 6 6 6 6 6 6 6 6 6 6 6 6 6 6 6 6 6 6 6 
6 6 6 6 6 6 6 6 6 6 6 6 6 6 6 6 6 6 6 6 6 6 6 6 6 6 
6 6 6 6 6 6 6 6 6 6 6 0 0 0 0 6 6 6 6 6 6 6 6 6 6 6 
6 6 6 6 6 6 6 6 6 6 6 0 12 13 0 6 6 6 6 6 6 6 6 6 6 6 
6 6 6 6 6 6 6 6 6 6 6 0 14 15 0 6 6 6 6 6 6 6 6 6 6 6 
