1
6 6 6 6 6 6 6 6 6 6 6 6 6 6 6 6 6 6 6 6 6 6 6 6 6 6 
6 6 6 6 6 6 6 6 6 6 6 6 6 6 6 6 6 6 6 6 6 6 6 6 6 6 
6 6 1 1 6 6 6 6 6 6 8 9 8 9 8 9 8 9 8 9 6 6 6 6 6 6 
6 6 1 1 6 6 6 6 6 6 10 11 10 11 10 11 10 11 10 11 6 6 6 6 6 6 
6 6 1 1 6 6 6 6 6 6 8 9 6 6 6 6 6 6 6 6 6 6 6 6 6 6 
6 6 1 1 6 6 6 6 6 6 10 11 6 6 6 6 6 6 6 6 6 6 6 6 6 6 
6 6 1 1 6 6 6 6 6 6 8 9 6 6 6 6 6 6 6 6 6 6 6 6 6 6 
6 6 1 1 6 6 6 6 6 6 10 11 6 6 6 6 6 6 6 6 6 6 6 6 6 6 
6 6 1 1 6 6 6 6 6 6 8 9 6 6 6 6 6 6 6 6 6 6 6 6 6 6 
6 6 1 1 6 6 6 6 6 6 10 11 6 6 6 6 6 6 6 6 6 6 6 6 6 6 
6 6 1 1 6 6 6 6 6 6 8 9 8 9 8 9 8 9 8 9 6 6 6 6 6 6 
6 6 1 1 6 6 6 6 6 6 10 11 10 11 10 11 10 11 10 11 6 6 6 6 6 6 
6 6 1 1 6 6 6 6 6 6 6 6 6 6 6 6 6 6 8 9 6 6 6 6 6 6 
6 6 1 1 6 6 6 6 6 6 6 6 6 6 6 6 6 6 10 11 6 6 6 6 6 6 
6 6 1 1 6 6 6 6 6 6 6 6 6 6 6 6 6 6 8 9 6 6 6 6 6 6 
6 6 1 1 6 6 6 6 6 6 6 6 6 6 6 6 6 6 10 11 6 6 6 6 6 6 
6 6 6 6 6 6 6 6 6 6 8 9 8 9 8 9 8 9 8 9 6 6 6 6 6 6 
6 6 6 6 6 6 6 6 6 6 10 11 10 11 10 11 10 11 10 11 6 6 6 6 6 6 
6 6 6 6 6 6 6 6 6 6 6 6 6 6 6 6 6 6 6 6 6 6 6 6 6 6 
6 6 6 6 6 6 6 6 6 6 6 6 6 6 6 6 6 6 6 6 6 6 6 6 6 6 
6 6 6 6 6 6 6 6 6 6 6 6 6 6 6 6 6 6 6 6 6 6 6 6 6 6 
6 6 6 6 6 6 6 6 6 6 6 6 6 6 6 6 6 6 6 6 6 6 6 6 6 6 
6 6 6 6 6 6 6 6 6 6 6 6 6 6 6 6 6 6 6 6 6 6 6 6 6 6 
6 6 6 6 6 6 6 6 6 6 6 0 0 0 0 6 6 6 6 6 6 6 6 6 6 6 
6 6 6 6 6 6 6 6 6 6 6 0 12 13 0 6 6 6 6 6 6 6 6 6 6 6 
6 6 6 6 6 6 6 6 6 6 6 0 14 15 0 6 6 6 6 6 6 6 6 6 6 6 
